Rk,Name,Born,Pos,GP,G,A,P,PIM
1,Wayne Gretzky,1961,F,1487,894,1963,2857,577
2,Jaromir Jagr,1972,F,1733,766,1155,1921,1167
3,Mark Messier,1961,F,1756,694,1193,1887,1912
4,Gordie Howe,1928,F,1767,801,1049,1850,1685
5,Ron Francis,1963,F,1731,549,1249,1798,977
6,Marcel Dionne,1951,F,1348,731,1040,1771,600
7,Steve Yzerman,1965,F,1514,692,1063,1755,924
8,Mario Lemieux,1965,F,915,690,1033,1723,834
9,Joe Sakic,1969,F,1378,625,1016,1641,614
10,Phil Esposito,1942,F,1282,717,873,1590,910
11,Ray Bourque,1960,D,1612,410,1169,1579,1141
12,Joe Thornton,1979,F,1714,430,1109,1539,1272
13,Mark Recchi,1968,F,1652,577,956,1533,1033
14,Paul Coffey,1961,D,1409,396,1135,1531,1802
15,Stan Mikita,1940,F,1396,541,926,1467,1264
16,Teemu Selanne,1970,F,1451,684,773,1457,660
17,Bryan Trottier,1956,F,1279,524,901,1425,912
18,Adam Oates,1962,F,1337,341,1079,1420,415
19,Doug Gilmour,1963,F,1474,450,964,1414,1301
20,Alexander Ovechkin,1985,F,1274,780,630,1410,749
21,Dale Hawerchuk,1963,F,1188,518,891,1409,740
22,Sidney Crosby,1987,F,1108,517,892,1409,731
23,Jari Kurri,1960,F,1251,601,797,1398,545
24,Luc Robitaille,1966,F,1431,668,726,1394,1177
25,Brett Hull,1964,F,1269,741,650,1391,458
26,Mike Modano,1970,F,1499,561,813,1374,926
27,Johnny Bucyk,1935,F,1540,556,813,1369,493
28,Brendan Shanahan,1969,F,1524,656,698,1354,2489
29,Guy Lafleur,1951,F,1126,560,793,1353,399
30,Mats Sundin,1971,F,1346,564,785,1349,1093
31,Dave Andreychuk,1963,F,1639,640,698,1338,1121
32,Denis Savard,1961,F,1196,473,865,1338,1336
33,Mike Gartner,1959,F,1432,708,627,1335,1159
34,Pierre Turgeon,1969,F,1294,515,812,1327,452
35,Gilbert Perreault,1950,F,1191,512,814,1326,500
36,Jarome Iginla,1977,F,1554,625,675,1300,1040
37,Alex Delvecchio,1932,F,1550,456,825,1281,383
38,Al MacInnis,1963,D,1416,340,934,1274,1511
39,Jean Ratelle,1940,F,1280,491,776,1267,276
40,Peter Stastny,1956,F,977,450,789,1239,824
41,Phil Housley,1964,D,1495,338,894,1232,822
42,Norm Ullman,1935,F,1410,490,739,1229,710
43,Jean Beliveau,1931,F,1125,507,712,1219,1033
44,Larry Murphy,1961,D,1615,288,929,1217,1084
45,Jeremy Roenick,1970,F,1363,513,703,1216,1463
46,Bobby Clarke,1949,F,1144,358,852,1210,1453
47,Bernie Nicholls,1961,F,1127,475,734,1209,1292
48,Vincent Damphousse,1967,F,1378,432,773,1205,1188
49,Dino Ciccarelli,1960,F,1232,608,592,1200,1425
50,Patrick Marleau,1979,F,1779,566,631,1197,527
51,Rod Brind'Amour,1970,F,1484,452,732,1184,1100
52,Patrick Kane,1988,F,1107,430,750,1180,410
53,Sergei Fedorov,1969,F,1248,483,696,1179,839
54,Bobby Hull,1939,F,1063,610,560,1170,634
55,Daniel Alfredsson,1972,F,1246,444,713,1157,510
56,Michel Goulet,1960,F,1089,548,605,1153,825
57,Evgeni Malkin,1986,F,981,444,702,1146,1008
58,Nicklas Lidstrom,1970,D,1564,264,878,1142,514
59,Marian Hossa,1979,F,1309,525,609,1134,628
60,Bernie Federko,1956,F,1000,369,761,1130,487
61,Mike Bossy,1957,F,752,573,553,1126,210
62,Joe Nieuwendyk,1966,F,1257,564,562,1126,677
63,Darryl Sittler,1950,F,1096,484,637,1121,948
64,Frank Mahovlich,1938,F,1181,533,570,1103,1054
65,Glenn Anderson,1960,F,1129,498,601,1099,1120
66,Theoren Fleury,1968,F,1084,455,633,1088,1840
67,Henrik Sedin,1980,F,1330,240,830,1070,680
68,Dave Taylor,1955,F,1111,431,638,1069,1589
69,Anze Kopitar,1987,F,1210,365,702,1067,318
70,Keith Tkachuk,1972,F,1201,538,527,1065,2219
71,Ray Whitney,1972,F,1330,385,679,1064,465
72,Joe Mullen,1957,F,1062,502,561,1063,241
73,Pat Verbeek,1964,F,1424,522,540,1062,2905
74,Denis Potvin,1953,D,1060,310,742,1052,1356
75,Henri Richard,1936,F,1258,358,688,1046,932
76,Daniel Sedin,1980,F,1306,393,648,1041,546
77,Bobby Smith,1958,F,1077,357,679,1036,919
78,Eric Staal,1984,F,1293,441,593,1034,828
79,Martin St. Louis,1975,F,1134,391,642,1033,310
80,Doug Weight,1971,F,1238,278,755,1033,970
81,Alexander Mogilny,1969,F,990,473,559,1032,432
82,Alexei Kovalev,1973,F,1316,430,599,1029,1304
83,Brian Leetch,1968,D,1205,247,781,1028,571
84,Patrik Elias,1976,F,1240,408,617,1025,549
85,Brian Bellows,1964,F,1188,485,537,1022,718
86,Rod Gilbert,1941,F,1065,406,615,1021,510
87,Dale Hunter,1960,F,1407,323,697,1020,3565
88,Ryan Getzlaf,1985,F,1157,282,737,1019,960
89,Pat Lafontaine,1965,F,865,468,545,1013,552
90,Steve Larmer,1961,F,1006,441,571,1012,532
91,Nicklas Backstrom,1987,F,1058,264,747,1011,488
92,Lanny McDonald,1953,F,1111,500,506,1006,899
93,Brian Propp,1959,F,1016,425,579,1004,825
94,Jason Spezza,1983,F,1248,363,632,995,604
95,Paul Kariya,1974,F,989,402,587,989,399
96,Rick Middleton,1953,F,1005,448,540,988,157
97,Dave Keon,1940,F,1296,396,590,986,117
98,Patrice Bergeron,1985,F,1216,400,582,982,472
99,Andy Bathgate,1932,F,1069,349,624,973,624
100,Steven Stamkos,1990,F,922,481,491,972,551
101,Shane Doan,1976,F,1540,402,570,972,1353
102,Maurice Richard,1921,F,978,544,422,966,1287
103,Henrik Zetterberg,1980,F,1082,337,623,960,401
104,Kirk Muller,1966,F,1349,357,602,959,1228
105,Larry Robinson,1951,D,1384,208,750,958,793
106,Phil Kessel,1987,F,1204,399,557,956,372
107,Rick Tocchet,1964,F,1144,440,512,952,2970
108,Vincent Lecavalier,1980,F,1212,421,528,949,848
109,Chris Chelios,1962,D,1651,185,763,948,2891
110,Jason Arnott,1974,F,1244,417,521,938,1242
111,Steve Thomas,1963,F,1235,421,512,933,1306
112,Brad Richards,1980,F,1126,298,634,932,251
113,Joe Pavelski,1984,F,1168,421,503,924,430
114,Claude Giroux,1988,F,1018,294,629,923,418
115,Neal Broten,1959,F,1099,289,634,923,569
116,Pavel Datsyuk,1978,F,953,314,604,918,228
117,Bobby Orr,1948,D,657,270,645,915,953
118,Gary Roberts,1966,F,1224,438,472,910,2560
119,Scott Stevens,1964,D,1635,196,712,908,2785
120,Tony Amonte,1970,F,1174,416,484,900,752
121,Ray Ferraro,1964,F,1258,408,490,898,1288
122,Brad Park,1948,D,1113,213,683,896,1429
123,John Tavares,1990,F,949,391,504,895,411
124,Peter Bondra,1968,F,1081,503,389,892,761
125,Butch Goring,1949,F,1107,375,513,888,102
126,Owen Nolan,1972,F,1200,422,463,885,1793
127,Peter Forsberg,1973,F,708,249,636,885,690
128,Bill Barber,1952,F,903,420,463,883,623
129,Dennis Maruk,1955,F,888,356,522,878,761
130,Ilya Kovalchuk,1983,F,926,443,433,876,544
131,Markus Naslund,1973,F,1117,395,474,869,736
132,Cliff Ronning,1965,F,1137,306,563,869,453
133,Trevor Linden,1970,F,1382,375,492,867,895
134,Blake Wheeler,1986,F,1046,296,571,867,695
135,Ivan Boldirev,1949,F,1052,361,505,866,507
136,Eric Lindros,1973,F,760,372,493,865,1398
137,Yvan Cournoyer,1943,F,968,428,435,863,233
138,Alex Tanguay,1979,F,1088,283,580,863,527
139,Dean Prentice,1932,F,1378,391,469,860,487
140,Corey Perry,1985,F,1176,405,453,858,1285
141,Bill Guerin,1970,F,1263,429,427,856,1660
142,Tomas Sandstrom,1964,F,983,394,462,856,1193
143,Vyacheslav Kozlov,1972,F,1182,356,497,853,704
144,Jonathan Toews,1988,F,1014,357,495,852,564
145,Ted Lindsay,1925,F,1068,379,472,851,1808
146,Zach Parise,1984,F,1142,408,437,845,412
147,Gary Suter,1964,D,1145,203,641,844,1349
148,Tom Lysiak,1953,F,919,292,551,843,567
149,John MacLean,1964,F,1194,413,429,842,1328
150,Ryan Smyth,1976,F,1270,386,456,842,976
151,Scott Mellanby,1966,F,1431,364,476,840,2479
152,John Tonelli,1957,F,1028,325,511,836,911
153,Jacques Lemaire,1945,F,853,366,469,835,217
154,Saku Koivu,1974,F,1124,255,577,832,809
155,Brent Sutter,1962,F,1111,363,466,829,1054
156,John Ogrodnick,1959,F,928,402,425,827,260
157,Doug Wilson,1957,D,1024,237,590,827,830
158,Leonard 'Red' Kelly,1927,F,1316,281,542,823,327
159,Pierre Larouche,1955,F,812,395,427,822,237
160,Bernie Geoffrion,1931,F,883,393,429,822,683
161,Stephane Richer,1966,F,1054,421,398,819,614
162,John Leclair,1969,F,967,406,413,819,501
163,Steve Shutt,1952,F,930,424,393,817,410
164,Tom Steen,1960,F,950,264,553,817,753
165,Marian Gaborik,1982,F,1035,407,408,815,492
166,Wilf Paiement,1955,F,946,356,458,814,1759
167,Peter McNab,1952,F,955,363,450,813,179
168,Sergei Gonchar,1974,D,1301,220,591,811,981
169,Hubert 'Pit' Martin,1943,F,1101,324,485,809,609
170,Jeff Carter,1985,F,1170,418,389,807,593
171,Ken Linseman,1958,F,860,256,551,807,1725
172,Rick Nash,1984,F,1060,437,368,805,750
173,Milan Hejduk,1976,F,1020,375,430,805,316
174,Garry Unger,1947,F,1105,413,391,804,1075
175,Ken Hodge,1944,F,880,328,472,800,777
176,Paul Stastny,1985,F,1072,284,516,800,484
177,Jakub Voracek,1989,F,1047,222,578,800,525
178,Geoff Courtnall,1962,F,1048,367,432,799,1463
179,Justin Williams,1981,F,1264,320,477,797,766
180,Brad Marchand,1988,F,874,351,444,795,899
181,Ed Olczyk,1966,F,1031,342,452,794,874
182,Wayne Cashman,1945,F,1027,277,516,793,1039
183,Mike Ribeiro,1980,F,1074,228,565,793,577
184,Dany Heatley,1981,F,869,372,419,791,620
185,Thomas Vanek,1984,F,1029,373,416,789,547
186,Rick Vaive,1959,F,876,441,347,788,1445
187,Borje Salming,1951,D,1148,150,637,787,1344
188,Claude Lemieux,1965,F,1215,379,407,786,1777
189,Alexei Yashin,1973,F,850,337,444,781,401
190,Pavel Bure,1971,F,702,437,342,779,484
191,Rob Blake,1969,D,1270,240,537,777,1679
192,Brent Burns,1985,D,1251,227,550,777,763
193,Jean Pronovost,1945,F,998,391,383,774,413
194,Dave Christian,1959,F,1009,340,433,773,284
195,Pete Mahovlich,1946,F,883,288,485,773,916
196,Sergei Zubov,1970,D,1068,152,619,771,337
197,Todd Bertuzzi,1975,F,1159,314,456,770,1478
198,Jamie Benn,1989,F,948,329,440,769,734
199,Pavol Demitra,1974,F,847,304,464,768,284
200,Rick Kehoe,1951,F,906,371,396,767,120
201,Vaclav Prospal,1975,F,1108,255,510,765,581
202,Brian Rolston,1973,F,1256,342,419,761,472
203,Kevin Dineen,1963,F,1188,355,405,760,2229
204,Rick MacLeish,1950,F,846,349,410,759,434
205,Murray Craven,1964,F,1071,266,493,759,524
206,Mike Ridley,1963,F,866,292,466,758,424
207,Scott Young,1967,F,1181,342,415,757,448
208,Scott Gomez,1979,F,1079,181,575,756,655
209,Steve Duchesne,1965,D,1113,227,525,752,824
210,Craig Janney,1967,F,760,188,563,751,170
211,Olli Jokinen,1978,F,1231,321,429,750,1071
212,Bobby Holik,1971,F,1314,326,421,747,1423
213,Steve Sullivan,1974,F,1011,290,457,747,587
214,Russ Courtnall,1965,F,1029,297,447,744,557
215,Greg Adams,1963,F,1056,355,388,743,321
216,Mathieu Schneider,1969,D,1289,223,520,743,1245
217,Mark Howe,1955,D,929,197,545,742,455
218,Scott Niedermayer,1973,D,1263,172,568,740,784
219,Miroslav Satan,1974,F,1050,363,372,735,464
220,Andrew Brunette,1973,F,1110,268,465,733,314
221,Andrew Cassels,1969,F,1015,204,528,732,410
222,Matt Cullen,1976,F,1516,266,465,731,592
223,David Krejci,1986,F,962,215,515,730,339
224,Bobby Carpenter,1963,F,1178,320,408,728,919
225,Murray Oliver,1937,F,1127,274,454,728,315
226,Mike Foligno,1959,F,1018,355,372,727,2047
227,Jason Pominville,1982,F,1060,293,434,727,199
228,Cory Stillman,1973,F,1025,278,449,727,489
229,Kevin Stevens,1965,F,874,329,397,726,1470
230,Bob Nevin,1938,F,1128,307,419,726,215
231,Dave Babych,1961,D,1195,142,581,723,970
232,Petr Sykora,1976,F,1017,323,398,721,455
233,Dave Gagner,1964,F,946,318,401,719,1018
234,Alexei Zhamnov,1970,F,807,249,470,719,668
235,Petr Nedved,1971,F,982,310,407,717,708
236,Martin Straka,1972,F,954,257,460,717,360
237,Zigmund Palffy,1972,F,684,329,384,713,322
238,George Armstrong,1930,F,1188,296,417,713,726
239,Dustin Brown,1984,F,1296,325,387,712,738
240,Vic Hadfield,1940,F,1004,323,389,712,1159
241,Charlie Simmer,1954,F,712,342,369,711,544
242,Mikko Koivu,1983,F,1035,206,505,711,594
243,Doug Mohns,1933,D,1391,248,462,710,1261
244,Scott Hartnell,1982,F,1249,327,380,707,1809
245,Marc Savard,1977,F,807,207,499,706,737
246,Robert Lang,1970,F,989,261,442,703,422
247,Bobby Rousseau,1940,F,942,245,458,703,357
248,Rene Robert,1948,F,744,284,418,702,597
249,Rick Martin,1951,F,685,384,317,701,477
250,Mel Bridgman,1955,F,977,252,449,701,1625
251,Geoff Sanderson,1972,F,1104,355,345,700,511
252,Chris Pronger,1974,D,1167,157,541,698,1590
253,Clark Gillies,1954,F,958,319,378,697,1025
254,Connor McDavid,1997,F,487,239,458,697,183
255,Daniel Briere,1977,F,973,307,389,696,744
256,Cam Neely,1965,F,726,395,299,694,1241
257,Shayne Corson,1966,F,1156,273,420,693,2357
258,Matt Duchene,1991,F,905,294,394,688,234
259,Tyler Seguin,1992,F,825,305,381,686,253
260,Kent Nilsson,1956,F,553,264,422,686,116
261,Danny Gare,1954,F,827,354,331,685,1285
262,Dan Quinn,1965,F,805,266,419,685,531
263,Reed Larson,1956,D,904,222,463,685,1388
264,Don Lever,1952,F,1020,313,367,680,593
265,Zdeno Chara,1977,D,1680,209,471,680,2085
266,Michael Nylander,1972,F,920,209,470,679,468
267,Walt Tkaczuk,1947,F,945,227,451,678,556
268,Kevin Hatcher,1966,D,1157,227,450,677,1392
269,Jozef Stumpel,1972,F,957,196,481,677,245
270,Tim Kerr,1960,F,655,370,304,674,596
271,Mike Bullard,1961,F,727,329,345,674,705
272,Phil Goyette,1933,F,940,207,467,674,123
273,Paul MacLean,1958,F,719,324,349,673,968
274,Stan Smyl,1958,F,896,262,411,673,1556
275,Daymond Langkow,1976,F,1090,270,402,672,547
276,Craig Ramsay,1951,F,1070,252,420,672,201
277,Ryan O'Reilly,1991,F,938,240,432,672,136
278,Reggie Leach,1950,F,934,381,285,666,387
279,David Perron,1988,F,973,269,396,665,718
280,Guy Carbonneau,1960,F,1318,260,403,663,820
281,Jamie Langenbrunner,1975,F,1109,243,420,663,837
282,Martin Gelinas,1970,F,1273,309,351,660,820
283,Erik Karlsson,1990,D,838,153,507,660,386
284,Red Berenson,1939,F,987,261,397,658,303
285,Kelly Kisio,1959,F,761,229,429,658,768
286,Ray Sheppard,1966,F,817,357,300,657,212
287,Taylor Hall,1991,F,761,248,409,657,418
288,Ulf Dahlen,1967,F,966,301,354,655,230
289,Dennis Hull,1944,F,959,303,351,654,259
290,Barry Pederson,1961,F,701,238,416,654,472
291,Glen Murray,1972,F,1009,337,314,651,679
292,Bryan Smolinski,1971,F,1056,274,377,651,606
293,Kristopher Letang,1987,D,941,144,506,650,661
294,Nathan MacKinnon,1995,F,638,242,406,648,276
295,Randy Carlyle,1956,D,1055,148,499,647,1400
296,Ryan Walter,1958,F,1003,264,382,646,946
297,Duncan Keith,1983,D,1256,106,540,646,675
298,Igor Larionov,1960,F,921,169,475,644,474
299,Bob Pulford,1936,F,1079,281,362,643,793
300,Max Pacioretty,1988,F,850,323,319,642,466
301,Mike Cammalleri,1982,F,906,294,348,642,425
302,Ron Ellis,1945,F,1034,332,308,640,207
303,Tony McKegney,1958,F,912,320,319,639,517
304,Ralph Backstrom,1937,F,1032,278,361,639,389
305,James Patrick,1963,D,1280,149,490,639,759
306,Ryan Suter,1985,D,1280,100,539,639,707
307,Roman Hamrlik,1974,D,1395,155,483,638,1408
308,Teppo Numminen,1968,D,1372,117,520,637,513
309,Brian Sutter,1956,F,779,303,333,636,1786
310,Anton Stastny,1959,F,650,252,384,636,150
311,T.J. Oshie,1986,F,900,271,364,635,438
312,Mats Naslund,1959,F,651,251,383,634,111
313,Logan Couture,1989,F,845,296,337,633,232
314,John Anderson,1957,F,814,282,349,631,261
315,Robert Reichel,1971,F,830,252,378,630,388
316,Esa Tikkanen,1965,F,877,244,386,630,1077
317,Brent Ashton,1960,F,998,284,345,629,637
318,Ed Westfall,1940,F,1226,231,394,625,544
319,Radim Vrbata,1981,F,1057,284,339,623,294
320,Elmer Lach,1918,F,664,215,408,623,478
321,Brian Mullen,1962,F,832,260,362,622,416
322,Alexander Steen,1984,F,1018,245,377,622,454
323,Guy Lapointe,1948,D,884,171,451,622,893
324,Patrick Sharp,1981,F,939,287,333,620,536
325,Ron Duguay,1957,F,864,274,346,620,582
326,Chris Kunitz,1979,F,1022,268,351,619,746
327,Keith Primeau,1971,F,909,266,353,619,1541
328,Keith Yandle,1986,D,1109,103,516,619,616
329,David Legwand,1980,F,1136,228,390,618,551
330,Adam Graves,1968,F,1152,329,287,616,1224
331,Leon Draisaitl,1995,F,558,254,362,616,206
332,Nikita Kucherov,1993,F,562,246,370,616,283
333,Fred Stanfield,1944,F,914,211,405,616,134
334,Chris Drury,1976,F,892,255,360,615,468
335,Loui Eriksson,1985,F,1050,253,360,613,200
336,Jonathan Huberdeau,1993,F,671,198,415,613,341
337,Derek King,1967,F,830,261,351,612,417
338,Martin Rucinsky,1971,F,961,241,371,612,821
339,Jordan Staal,1988,F,1092,258,353,611,523
340,Ron Greschner,1954,D,981,179,431,610,1226
341,Johnny Gaudreau,1993,F,602,210,399,609,132
342,Tomas Plekanec,1982,F,1001,233,375,608,543
343,Dickie Moore,1931,F,719,261,346,607,646
344,Peter Zezel,1965,F,873,219,388,607,435
345,Walt McKechnie,1947,F,955,214,392,606,469
346,Terry O'Reilly,1951,F,891,204,402,606,2095
347,Syl Apps,1947,F,727,183,423,606,311
348,Mike Ricci,1971,F,1099,243,362,605,974
349,Dan Boyle,1976,D,1093,163,442,605,693
350,Victor Hedman,1990,D,898,134,469,603,624
351,Bert Olmstead,1926,F,848,181,421,602,887
352,Simon Gagne,1980,F,822,291,310,601,328
353,Brendan Morrison,1975,F,934,200,401,601,452
354,Garry Galley,1963,D,1149,125,475,600,1218
355,Michal Pivonka,1966,F,825,181,418,599,476
356,Stu Barnes,1970,F,1136,261,336,597,438
357,Dmitri Khristich,1969,F,811,259,337,596,422
358,Brian Gionta,1979,F,1026,291,304,595,377
359,Jordan Eberle,1990,F,858,262,333,595,200
360,Martin Havlat,1981,F,790,242,352,594,404
361,Jean-Paul Parise,1941,F,890,238,356,594,706
362,Thomas Gradin,1956,F,677,209,384,593,298
363,John Carlson,1990,D,887,132,461,593,290
364,Al MacAdam,1952,F,864,240,351,591,509
365,Dainius Zubrus,1978,F,1293,228,363,591,791
366,Radek Dvorak,1977,F,1260,227,363,590,449
367,Mike Fisher,1980,F,1104,278,311,589,815
368,Don Marshall,1932,F,1176,265,324,589,125
369,Claude Provost,1933,F,1005,254,335,589,475
370,Shea Weber,1985,D,1038,224,365,589,714
371,Patrik Sundstrom,1961,F,679,219,369,588,349
372,Carol Vadnais,1945,D,1087,169,418,587,1811
373,Steve Vickers,1951,F,698,246,340,586,330
374,Mario Tremblay,1956,F,852,258,326,584,1043
375,Troy Murray,1962,F,915,230,354,584,875
376,Keith Acton,1958,F,1023,226,358,584,1172
377,Jeff Brown,1966,D,747,154,430,584,498
378,Bob Bourne,1954,F,964,258,324,582,605
379,Don McKenney,1934,F,798,237,345,582,205
380,Tom Fergus,1962,F,726,235,346,581,499
381,Fredrik Olausson,1966,D,1022,147,434,581,452
382,Shawn McEachern,1969,F,911,256,323,579,506
383,Mark Scheifele,1993,F,642,230,347,577,260
384,Laurie Boschman,1960,F,1009,229,348,577,2263
385,Bob MacMillan,1952,F,752,228,349,577,260
386,Brenden Morrow,1979,F,991,265,310,575,1362
387,Milt Schmidt,1918,F,776,229,346,575,466
388,Guy Chouinard,1956,F,578,205,370,575,120
389,Eric Desjardins,1969,D,1143,136,439,575,757
390,Eric Nesterenko,1933,F,1219,250,324,574,1275
391,Petr Klima,1964,F,786,313,260,573,671
392,Jim Pappin,1939,F,767,278,295,573,667
393,Ryan Kesler,1984,F,1001,258,315,573,920
394,Dick Duff,1936,F,1030,283,289,572,743
395,Ales Hemsky,1983,F,845,174,398,572,353
396,Joe Juneau,1968,F,828,156,416,572,272
397,Andrei Markov,1978,D,990,119,453,572,505
398,Gabriel Landeskog,1992,F,738,248,323,571,601
399,Sergei Samsonov,1978,F,888,235,336,571,209
400,Kimmo Timonen,1975,D,1108,117,454,571,654
401,Bobby Ryan,1987,F,866,261,308,569,470
402,Mike Krushelnyski,1960,F,897,241,328,569,699
403,Artemi Panarin,1991,F,508,187,382,569,146
404,Chris Gratton,1975,F,1092,214,354,568,1638
405,Dave Ellett,1964,D,1129,153,415,568,985
406,Bill Gadsby,1927,D,1248,130,438,568,1539
407,Drew Doughty,1989,D,1014,132,435,567,691
408,Ross Lonsberry,1947,F,968,256,310,566,806
409,Milan Lucic,1988,F,1096,226,339,565,1256
410,Wendel Clark,1966,F,793,330,234,564,1690
411,Kyle Okposo,1988,F,909,219,345,564,486
412,Don Maloney,1958,F,765,214,350,564,815
413,Sandis Ozolinsh,1972,D,875,167,397,564,638
414,Rob Ramage,1959,D,1044,139,425,564,2226
415,Jussi Jokinen,1983,F,951,191,372,563,377
416,Tomas Kaberle,1978,D,984,87,476,563,260
417,James van Riemsdyk,1989,F,879,288,274,562,346
418,Jimmy Carson,1968,F,626,275,286,561,254
419,David Backes,1984,F,965,248,313,561,1148
420,Tony Tanti,1963,F,697,287,273,560,661
421,Ted Kennedy,1925,F,696,230,330,560,432
422,James Neal,1987,F,869,296,263,559,581
423,Paul Reinhart,1960,D,648,133,426,559,277
424,Billy Harris,1952,F,897,231,327,558,394
425,Bobby Schmautz,1945,F,764,271,286,557,988
426,Mike Murphy,1950,F,831,238,318,556,514
427,Pete Stemkowski,1943,F,967,206,349,555,864
428,Joshua Bailey,1989,F,993,176,379,555,239
429,Bengt-Ake Gustafsson,1958,F,629,195,359,554,196
430,Don Luce,1948,F,894,225,328,553,364
431,Aleksander Barkov,1995,F,596,220,333,553,116
432,Travis Zajac,1985,F,1037,203,349,552,344
433,Andrew Ladd,1985,F,1001,256,294,550,615
434,John Cullen,1964,F,621,187,363,550,898
435,Bill Cowley,1912,F,549,195,354,549,143
436,Mike Knuble,1972,F,1068,278,270,548,641
437,Mike Sillinger,1971,F,1049,240,308,548,644
438,Evander Kane,1991,F,812,286,259,545,1048
439,Martin Erat,1981,F,881,176,369,545,506
440,Max Bentley,1920,F,646,245,299,544,177
441,Mark Giordano,1983,D,1024,151,393,544,816
442,Benoit Hogue,1966,F,863,222,321,543,877
443,Doug Bentley,1916,F,565,219,324,543,217
444,Jeff Skinner,1992,F,853,298,244,542,378
445,Gary Dornhoefer,1943,F,787,214,328,542,1291
446,Craig Conroy,1971,F,1009,182,360,542,603
447,Roman Josi,1990,D,760,140,402,542,300
448,Bill Goldsworthy,1944,F,771,283,258,541,796
449,Mark Napier,1957,F,767,235,306,541,157
450,Patric Hornqvist,1987,F,879,263,277,540,453
451,Bill Mosienko,1921,F,711,258,282,540,133
452,Doug Harvey,1924,D,1113,88,452,540,1225
453,Viktor Kozlov,1975,F,897,198,339,537,248
454,Glen Wesley,1968,D,1457,128,409,537,1045
455,Danny Grant,1946,F,736,263,273,536,239
456,Tim Young,1955,F,629,195,341,536,438
457,Ron Sutter,1963,F,1093,205,330,535,1354
458,Calle Johansson,1967,D,1109,119,416,535,519
459,Kenny Wharram,1933,F,766,252,281,533,220
460,Erik Cole,1978,F,892,265,267,532,659
461,Mark Osborne,1961,F,919,212,319,531,1152
462,Tomas Holmstrom,1973,F,1026,243,287,530,769
463,Guy Charron,1949,F,734,221,309,530,146
464,Dave Poulin,1958,F,724,205,325,530,482
465,Valtteri Filppula,1984,F,1056,197,333,530,346
466,Ron Stewart,1932,F,1353,276,253,529,564
467,Syd Howe,1911,F,700,237,292,529,214
468,Toe Blake,1912,F,577,235,294,529,282
469,Camille Henry,1933,F,727,279,249,528,82
470,Joe Murphy,1967,F,779,233,295,528,810
471,Ryan Nugent-Hopkins,1993,F,719,196,332,528,239
472,Bryan McCabe,1975,D,1135,145,383,528,1732
473,Doug Bodger,1966,D,1071,106,422,528,1007
474,Ryan Johansen,1992,F,787,177,350,527,480
475,Lucien Deblois,1957,F,993,249,276,525,814
476,Dustin Byfuglien,1985,D,869,177,348,525,1094
477,Wayne Simmonds,1988,F,1019,263,261,524,1264
478,Vladimir Tarasenko,1991,F,606,252,272,524,177
479,Brayden Schenn,1991,F,776,219,305,524,425
480,Derek Roy,1983,F,738,189,335,524,391
481,Jean-Pierre Dumont,1978,F,822,214,309,523,364
482,Derick Brassard,1987,F,951,202,320,522,435
483,Bryan Little,1987,F,843,217,304,521,293
484,Mike Rogers,1954,F,484,202,317,519,184
485,Tim Horton,1930,D,1445,115,403,518,1611
486,Alexander Semin,1984,F,650,239,278,517,582
487,Ron Schock,1943,F,909,166,351,517,258
488,Alex Pietrangelo,1990,D,879,129,388,517,299
489,Yanic Perreault,1971,F,859,247,269,516,402
490,Jeff Friesen,1976,F,893,218,298,516,488
491,Nels Stewart,1902,F,650,324,191,515,955
492,Mika Zibanejad,1993,F,685,229,286,515,185
493,Antoine Vermette,1982,F,1046,228,287,515,622
494,Aaron Broten,1960,F,748,186,329,515,441
495,Brian Rafalski,1973,D,833,79,436,515,282
496,Jere Lehtinen,1973,F,875,243,271,514,210
497,Bob Murray,1954,D,1008,132,382,514,873
498,Tiger Williams,1954,F,962,241,272,513,3971
499,Bobby Nystrom,1952,F,900,235,278,513,1248
500,Nazem Kadri,1990,F,739,219,293,512,589
501,Shawn Horcoff,1978,F,1008,186,325,511,624
502,Patrick Flatley,1963,F,780,170,340,510,686
503,Donald Audette,1969,F,735,260,249,509,584
504,Mark Johnson,1957,F,669,203,305,508,269
505,Joel Otto,1961,F,943,195,313,508,1934
506,Darryl Sydor,1972,D,1291,98,409,507,755
507,Mats Zuccarello,1987,F,688,164,342,506,265
508,Nick Libett,1945,F,982,237,268,505,472
509,Brad Boyes,1982,F,822,211,294,505,251
510,Sam Gagner,1989,F,967,184,321,505,427
511,David Pastrnak,1996,F,510,240,264,504,215
512,Derek Stepan,1990,F,817,177,327,504,208
513,Brian Campbell,1979,D,1082,87,417,504,277
514,Brian Bradley,1965,F,651,182,321,503,528
515,Dennis Hextall,1943,F,681,153,350,503,1398
516,Bob Gainey,1953,F,1160,239,262,501,585
517,Valeri Kamensky,1966,F,637,200,301,501,383
518,Greg Malone,1956,F,704,191,310,501,661
519,Mike Green,1985,D,880,150,351,501,592
520,Ed Jovanovski,1976,D,1128,137,363,500,1491
521,Nick Foligno,1987,F,1021,205,294,499,830
522,Gregg Sheppard,1949,F,657,205,293,498,243
523,Todd Marchant,1973,F,1195,186,312,498,774
524,Pierre Pilote,1931,D,890,80,418,498,1257
525,Craig Simpson,1967,F,634,247,250,497,657
526,Radek Bonk,1976,F,969,194,303,497,581
527,Al Secord,1958,F,766,273,223,496,2095
528,Jeff O'Neill,1976,F,821,237,259,496,670
529,Evgeny Kuznetsov,1992,F,599,153,343,496,308
530,Sylvain Turgeon,1965,F,669,269,226,495,691
531,Darcy Rota,1953,F,794,256,239,495,973
532,Lubomir Visnovsky,1976,D,883,128,367,495,373
533,Keith Crowder,1959,F,662,223,271,494,1354
534,Dion Phaneuf,1985,D,1048,137,357,494,1345
535,Tony Granato,1964,F,773,248,244,492,1425
536,Andre Boudrias,1943,F,662,151,340,491,216
537,Dirk Graham,1959,F,772,219,270,489,919
538,Andy McDonald,1977,F,685,182,307,489,280
539,Steve Rucchin,1971,F,735,171,318,489,164
540,Nelson Emerson,1967,F,771,195,293,488,575
541,Marco Sturm,1978,F,938,242,245,487,446
542,Mike Richards,1985,F,749,181,306,487,585
543,Jason Blake,1973,F,871,213,273,486,455
544,Bruce Driver,1962,D,922,96,390,486,670
545,Jason Allison,1975,F,552,154,331,485,441
546,Michael Ryder,1980,F,806,237,247,484,353
547,Don Marcotte,1947,F,868,230,254,484,317
548,Claude Larose,1942,F,944,226,257,483,889
549,Michal Handzus,1977,F,1009,185,298,483,498
550,Tod Sloan,1927,F,744,220,262,482,842
551,Andre Savard,1953,F,790,211,271,482,411
552,Craig MacTavish,1958,F,1093,213,267,480,891
553,Gerard Gallant,1963,F,615,211,269,480,1674
554,Yvon Lambert,1950,F,683,206,273,479,340
555,Ron Murphy,1933,F,889,205,274,479,456
556,Jim Fox,1960,F,578,186,293,479,143
557,Dale McCourt,1957,F,532,194,284,478,124
558,Paul Henderson,1943,F,707,236,241,477,304
559,Dit Clapper,1907,F,835,229,248,477,452
560,Dallas Drake,1969,F,1009,177,300,477,885
561,Howie Morenz,1902,F,550,271,205,476,562
562,Eric Vail,1953,F,591,216,260,476,281
563,Darcy Tucker,1975,F,947,215,261,476,1410
564,Mark Stone,1992,F,541,179,297,476,183
565,Busher Jackson,1911,F,634,241,234,475,450
566,John McKenzie,1937,F,692,206,268,474,923
567,Frans Nielsen,1984,F,925,167,306,473,166
568,Sid Abel,1918,F,612,188,284,472,376
569,Doug Risebrough,1954,F,740,185,286,471,1542
570,Alexei Zhitnik,1972,D,1085,96,375,471,1268
571,Bruce MacGregor,1941,F,895,213,257,470,215
572,Mike Keane,1967,F,1161,168,302,470,881
573,Filip Forsberg,1994,F,566,220,249,469,238
574,Lee Stempniak,1983,F,911,203,266,469,327
575,Rob Niedermayer,1974,F,1153,186,283,469,904
576,Steve Kasper,1961,F,821,177,291,468,554
577,Jyrki Lumme,1966,D,985,114,354,468,620
578,P.K. Subban,1989,D,834,115,352,467,905
579,Steve Payne,1958,F,613,228,238,466,435
580,Gary Leeman,1964,F,667,199,267,466,531
581,Eddie Shack,1937,F,1047,239,226,465,1431
582,Nikolai Antropov,1980,F,788,193,272,465,627
583,Mike Peca,1974,F,864,176,289,465,798
584,Mikael Renberg,1972,F,661,190,274,464,372
585,Doug Crossman,1960,D,914,105,359,464,534
586,Brent Seabrook,1985,D,1114,103,361,464,661
587,Aurele Joliat,1901,F,655,269,194,463,771
588,Jochen Hecht,1977,F,833,186,277,463,458
589,Kelly Miller,1963,F,1057,181,282,463,512
590,Al Iafrate,1966,D,799,152,311,463,1301
591,Fredrik Modin,1974,F,898,232,230,462,453
592,Sean Monahan,1994,F,656,212,250,462,153
593,Cliff Koroll,1946,F,814,208,254,462,376
594,Tyler Bozak,1986,F,814,170,291,461,236
595,Sean Couturier,1992,F,721,180,280,460,277
596,Doug Smail,1957,F,845,210,249,459,602
597,Ron Stackhouse,1949,D,889,87,372,459,824
598,Alex Goligoski,1985,D,996,85,374,459,342
599,Sami Kapanen,1973,F,831,189,269,458,175
600,Auston Matthews,1997,F,407,259,198,457,74
601,Wade Redden,1977,D,1023,109,348,457,665
602,Pierre Mondou,1955,F,548,194,262,456,179
603,Wayne Merrick,1952,F,774,191,265,456,303
604,Jude Drouin,1948,F,666,151,305,456,346
605,Travis Green,1970,F,970,193,262,455,764
606,Mitchell Marner,1997,F,427,138,317,455,138
607,Pelle Eklund,1963,F,594,120,335,455,109
608,Jerry Korab,1948,D,975,114,341,455,1629
609,J.T. Miller,1993,F,637,169,285,454,323
610,Pat Boutette,1952,F,756,171,282,453,1354
611,Charlie Huddy,1959,D,1017,99,354,453,785
612,Cam Atkinson,1989,F,700,236,216,452,156
613,Derek Sanderson,1946,F,598,202,250,452,911
614,Dan Maloney,1950,F,737,192,259,451,1489
615,Kristian Huselius,1978,F,662,190,261,451,256
616,Randy Burridge,1966,F,706,199,251,450,458
617,Blaine Stoughton,1953,F,526,258,191,449,204
618,Elias Lindholm,1994,F,663,181,268,449,162
619,Mike Walton,1945,F,588,201,247,448,357
620,Dean McAmmond,1973,F,996,186,262,448,490
621,Milan Michalek,1984,F,747,208,238,446,394
622,Dick Redmond,1949,D,771,133,312,445,504
623,Harry Watson,1923,F,809,236,207,443,150
624,Mikael Granlund,1992,F,671,135,308,443,197
625,Adam Henrique,1990,F,768,217,224,441,229
626,Shawn Burr,1966,F,878,181,259,440,1069
627,Ian Turnbull,1953,D,628,123,317,440,736
628,Mike O'Connell,1955,D,860,105,335,440,605
629,Serge Savard,1946,D,1040,106,333,439,590
630,Wayne Babych,1958,F,519,192,246,438,500
631,Rob Brown,1968,F,543,190,248,438,599
632,Brandon Dubinsky,1986,F,823,153,285,438,905
633,Willi Plett,1955,F,834,222,215,437,2570
634,Vic Stasiuk,1929,F,745,183,254,437,665
635,John Tucker,1964,F,656,177,259,436,285
636,Mikael Backlund,1989,F,826,166,270,436,395
637,Ron 'Chico' Maki,1939,F,841,143,293,436,345
638,Mariusz Czerkawski,1972,F,745,215,220,435,274
639,Sylvain Cote,1966,D,1171,122,313,435,545
640,Tyson Barrie,1991,D,683,95,340,435,207
641,Mark Streit,1977,D,786,96,338,434,374
642,Gaetan Duchesne,1962,F,1028,179,254,433,617
643,Allan Stanley,1926,D,1244,100,333,433,792
644,Kevin Shattenkirk,1989,D,816,93,340,433,470
645,Mario Marois,1957,D,956,76,357,433,1746
646,Syl Apps,1915,F,423,201,231,432,56
647,Curt Fraser,1958,F,704,193,239,432,1306
648,Christian Ruuttu,1964,F,621,134,298,432,714
649,Niklas Kronwall,1981,D,953,83,349,432,564
650,Lorne Carr,1910,F,580,204,227,431,132
651,Tim Connolly,1981,F,697,131,300,431,300
652,Kevin Lowe,1959,D,1254,84,347,431,1498
653,Woody Dumart,1916,F,774,211,219,430,99
654,Mike Hoffman,1989,F,612,204,226,430,219
655,Ab McDonald,1936,F,762,182,248,430,198
656,Tom Williams,1940,F,664,161,269,430,173
657,Hakan Loob,1960,F,450,193,236,429,189
658,Mickey Redmond,1947,F,538,233,195,428,219
659,Drew Stafford,1985,F,841,196,232,428,415
660,Jiri Hudler,1984,F,708,164,264,428,243
661,Alexander Edler,1986,D,966,102,326,428,699
662,Roy Conacher,1916,F,490,226,201,427,88
663,Ilkka Sinisalo,1958,F,582,204,223,427,208
664,Carey Wilson,1962,F,552,169,258,427,314
665,Hooley Smith,1903,F,717,200,226,426,1062
666,Andrew Cogliano,1987,F,1140,174,252,426,389
667,Terry Ruskowski,1954,F,629,113,313,426,1354
668,Kyle Turris,1989,F,776,168,257,425,343
669,Frank St. Marseille,1939,F,707,140,285,425,244
670,Jim Peplinski,1960,F,711,161,263,424,1467
671,Frank Boucher,1901,F,557,160,264,424,110
672,Phil Russell,1952,D,1016,99,325,424,2038
673,Derek Morris,1978,D,1107,92,332,424,1004
674,Jay Bouwmeester,1983,D,1240,88,336,424,635
675,Chris Kreider,1991,F,654,229,194,423,499
676,Gerry Meehan,1946,F,670,180,243,423,111
677,Bill Fairbairn,1947,F,658,162,261,423,173
678,Stephen Weiss,1983,F,732,156,267,423,341
679,Ondrej Palat,1991,F,628,143,280,423,197
680,Robert Picard,1957,D,899,104,319,423,1025
681,Walt Poddubny,1960,F,468,184,238,422,454
682,Nathan Horton,1985,F,627,203,218,421,567
683,Anson Carter,1974,F,674,202,219,421,229
684,Tom Kurvers,1962,D,659,93,328,421,350
685,Brandon Saad,1992,F,710,208,212,420,130
686,Joffrey Lupul,1983,F,701,205,215,420,407
687,Marty McInnis,1970,F,796,170,250,420,330
688,Patrice Brisebois,1971,D,1009,98,322,420,623
689,Gordie Roberts,1957,D,1097,61,359,420,1582
690,Morris Lukowich,1956,F,582,199,219,418,584
691,Harry Howell,1932,D,1411,94,324,418,1298
692,Bill Flett,1943,F,689,202,215,417,501
693,Reilly Smith,1991,F,686,174,243,417,176
694,Oliver Ekman-Larsson,1991,D,848,133,284,417,534
695,Marek Zidlicky,1977,D,836,89,328,417,680
696,Bill Derlago,1958,F,555,189,227,416,247
697,Ed Litzenberger,1932,F,619,178,238,416,275
698,Jason Chimera,1979,F,1107,186,229,415,892
699,Dave Balon,1938,F,777,192,222,414,607
700,Randy Cunneyworth,1961,F,866,189,225,414,1282
701,Brian MaClellan,1958,F,606,172,241,413,551
702,Matthew Stajan,1983,F,1003,146,267,413,526
703,Craig Hartsburg,1959,D,570,98,315,413,815
704,Torey Krug,1991,D,638,78,334,412,293
705,Darren Turcotte,1968,F,635,195,216,411,301
706,Phil Watson,1914,F,591,145,265,410,562
707,Alexandre Burrows,1981,F,913,205,204,409,1134
708,Pascal Dupuis,1979,F,871,190,219,409,387
709,Mikko Rantanen,1996,F,408,165,243,408,216
710,Jaden Schwartz,1992,F,597,162,246,408,167
711,Rejean Houle,1949,F,634,161,247,408,395
712,Sweeney Schriner,1911,F,484,201,206,407,148
713,Tomas Tatar,1990,F,701,191,216,407,246
714,Jerry Toppazzini,1931,F,784,163,244,407,433
715,Marcus Johansson,1990,F,753,144,263,407,112
716,Petri Skriko,1962,F,541,183,222,405,246
717,Earl Ingarfield,1934,F,746,179,226,405,225
718,Pat Hickey,1953,F,644,192,212,404,351
719,Blake Dunlop,1953,F,550,130,274,404,172
720,Mike McEwen,1956,D,716,108,296,404,460
721,Adam Creighton,1965,F,708,187,216,403,1077
722,Doug Jarvis,1955,F,964,139,264,403,263
723,Brad McCrimmon,1959,D,1222,81,322,403,1416
724,Paul Gardner,1956,F,447,201,201,402,207
725,Alex Killorn,1989,F,723,171,231,402,436
726,Bill Hicke,1938,F,729,168,234,402,389
727,Marc Tardif,1949,F,517,194,207,401,445
728,Sebastian Aho,1997,F,445,182,219,401,172
729,Gustav Nyquist,1989,F,652,164,237,401,170
730,Alan Haworth,1960,F,524,189,211,400,425
731,Valeri Bure,1974,F,621,174,226,400,221
732,Mike McPhee,1960,F,744,200,199,399,661
733,Tom McCarthy,1960,F,460,178,221,399,330
734,Jim Lorentz,1947,F,659,161,238,399,210
735,Adrian Aucoin,1973,D,1108,121,278,399,793
736,Petr Svoboda,1966,D,1028,58,341,399,1605
737,Eric Daze,1975,F,601,226,172,398,176
738,Herb Cain,1912,F,572,206,192,398,177
739,Craig Smith,1989,F,789,191,207,398,310
740,Matt Cooke,1978,F,1046,167,231,398,1135
741,Clint Smith,1913,F,483,161,237,398,24
742,George Ferguson,1952,F,797,160,238,398,431
743,Steve Chiasson,1967,D,751,93,305,398,1107
744,Alexander Frolov,1982,F,579,175,222,397,218
745,Anders Hedberg,1951,F,465,172,225,397,144
746,Scott Walker,1973,F,829,151,246,397,1162
747,Gus Bodnar,1923,F,667,142,255,397,207
748,Buddy O'Connor,1916,F,509,140,257,397,34
749,Charlie Conacher,1909,F,461,224,172,396,523
750,Steve Konowalchuk,1972,F,790,171,225,396,703
751,Maxim Afinogenov,1979,F,651,158,237,395,486
752,Errol Thompson,1950,F,599,208,185,393,184
753,Tyler Toffoli,1992,F,651,193,200,393,188
754,Kyle Palmieri,1991,F,681,200,192,392,365
755,R.J. Umberger,1982,F,779,180,212,392,312
756,Dennis Ververgaert,1953,F,583,176,216,392,247
757,Cal Gardner,1924,F,696,154,238,392,517
758,Andy Hebenton,1929,F,630,189,202,391,88
759,Lowell MacDonald,1941,F,506,180,210,390,88
760,Dave Manson,1967,D,1103,102,288,390,2792
761,Jarret Stoll,1982,F,872,144,244,388,618
762,Eric Weinrich,1966,D,1157,70,318,388,825
763,Mark Parrish,1977,F,722,216,171,387,246
764,Brock Nelson,1991,F,676,205,182,387,252
765,Marty Barry,1905,F,507,194,193,387,231
766,Tomas Hertl,1993,F,585,181,206,387,192
767,Ric Seiling,1957,F,738,179,208,387,573
768,Daniel Cleary,1978,F,938,165,222,387,492
769,Dennis Wideman,1983,D,815,99,288,387,503
770,Ryan Callahan,1985,F,757,186,200,386,428
771,Bill Hay,1935,F,506,113,273,386,244
772,Pavel Kubina,1977,D,970,110,276,386,1123
773,Mark Hunter,1962,F,628,213,171,384,1426
774,Bob Probert,1965,F,935,163,221,384,3300
775,Michael Frolik,1988,F,858,159,225,384,317
776,Harold 'Mush' March,1908,F,761,153,231,384,546
777,Sergei Makarov,1958,F,424,134,250,384,317
778,Zarley Zalapski,1968,D,637,99,285,384,684
779,Jeff Norton,1965,D,799,52,332,384,615
780,Jean-Guy Gendron,1934,F,864,182,201,383,695
781,Mike Grier,1975,F,1060,162,221,383,510
782,Bob Errey,1964,F,895,170,212,382,1005
783,Matthew Tkachuk,1997,F,431,152,230,382,425
784,Steven Reinprecht,1976,F,663,140,242,382,186
785,Brendan Gallagher,1992,F,638,194,187,381,397
786,Martin Lapointe,1973,F,991,181,200,381,1417
787,Todd White,1975,F,653,141,240,381,228
788,Jack Eichel,1996,F,409,153,227,380,152
789,Richard Zednik,1976,F,745,200,179,379,563
790,Andrei Kovalenko,1970,F,620,173,206,379,389
791,Orest Kindrachuk,1950,F,508,118,261,379,648
792,Vincent Trocheck,1993,F,555,150,228,378,372
793,Greg Gilbert,1962,F,837,150,228,378,576
794,Sam Reinhart,1995,F,532,167,210,377,103
795,German Titov,1965,F,624,157,220,377,311
796,Artem Anisimov,1988,F,771,180,196,376,214
797,Mike Johnson,1974,F,661,129,246,375,315
798,Steve Smith,1963,D,804,72,303,375,2139
799,Doug Brown,1964,F,854,160,214,374,210
800,John Klingberg,1992,D,552,71,303,374,213
801,Adam Deadmarsh,1975,F,567,184,189,373,819
802,Jeff Halpern,1976,F,976,152,221,373,641
803,Morgan Rielly,1994,D,654,69,304,373,181
804,Greg Paslawski,1961,F,650,187,185,372,169
805,Johnny Gottselig,1906,F,591,176,196,372,211
806,Dean Evason,1964,F,803,139,233,372,1002
807,Tony Hrkac,1966,F,758,132,239,371,173
808,Dougie Hamilton,1993,D,669,115,256,371,424
809,Johan Franzen,1979,F,602,187,183,370,401
810,Ryan Malone,1979,F,647,179,191,370,693
811,Juha Widing,1947,F,574,144,226,370,208
812,John-Michael Liles,1980,D,836,87,283,370,286
813,Moe Mantha,1961,D,656,81,289,370,501
814,Sid Smith,1925,F,601,186,183,369,90
815,Matt Moulson,1983,F,650,176,193,369,122
816,David Reid,1964,F,961,165,204,369,253
817,Fleming MacKell,1929,F,666,149,220,369,565
818,Greg Johnson,1971,F,785,145,224,369,345
819,Teuvo Teravainen,1994,F,526,118,251,369,100
820,Stefan Persson,1954,D,622,52,317,369,574
821,Nino Niederreiter,1992,F,732,181,187,368,352
822,Brayden Point,1996,F,417,167,201,368,121
823,Tyler Johnson,1990,F,615,164,204,368,198
824,Alexander Radulov,1986,F,524,144,224,368,344
825,Brad Maxwell,1957,D,613,98,270,368,1292
826,Jim Neilson,1940,D,1024,69,299,368,901
827,Mark Hardy,1959,D,915,62,306,368,1293
828,Bryan Hextall,1913,F,449,187,180,367,227
829,Gary Bergman,1938,D,838,68,299,367,1251
830,Bill Cook,1895,F,475,228,138,366,386
831,Anders Lee,1990,F,596,212,154,366,349
832,Jorgen Pettersson,1956,F,435,174,192,366,117
833,Ruslan Fedotenko,1979,F,863,173,193,366,472
834,Bo Horvat,1995,F,572,170,196,366,188
835,Grant Ledyard,1961,D,1028,90,276,366,764
836,Cam Fowler,1991,D,811,81,285,366,217
837,Mike Comrie,1980,F,589,168,197,365,443
838,Kris Draper,1971,F,1157,161,203,364,790
839,Troy Brouwer,1985,F,851,182,181,363,595
840,Randy McKay,1967,F,932,162,201,363,1731
841,J.C. Tremblay,1939,D,796,57,306,363,206
842,Bob Kelly,1950,F,837,154,208,362,1454
843,Jonathan Marchessault,1990,F,480,160,201,361,250
844,Paul Ranheim,1966,F,1013,161,199,360,288
845,Nick Leddy,1991,D,851,68,292,360,167
846,Brian Savage,1971,F,674,192,167,359,321
847,Tim Ecclestone,1947,F,692,126,233,359,344
848,Marty McSorley,1963,D,961,108,251,359,3381
849,Behn Wilson,1958,D,601,98,261,359,1480
850,Nikolaj Ehlers,1996,F,478,164,194,358,165
851,Kris Versteeg,1986,F,643,149,209,358,374
852,Dylan Larkin,1996,F,504,147,211,358,327
853,Eric Belanger,1977,F,820,138,220,358,361
854,John Van Boxmeer,1952,D,588,84,274,358,465
855,Jamie Macoun,1961,D,1128,76,282,358,1210
856,Gary Sabourin,1943,F,627,169,188,357,397
857,Ray Neufeld,1959,F,595,157,200,357,816
858,Ryan Strome,1993,F,621,130,227,357,376
859,Bill Clement,1950,F,719,148,208,356,383
860,Pierre-Marc Bouchard,1984,F,593,110,246,356,190
861,Matt Niskanen,1986,D,949,72,284,356,489
862,Dan Hamhuis,1982,D,1148,59,297,356,684
863,Barry Beck,1957,D,615,104,251,355,1016
864,Risto Siltanen,1958,D,562,90,265,355,266
865,Jaroslav Spacek,1974,D,880,82,273,355,618
866,Alex Galchenyuk,1994,F,643,146,208,354,253
867,Todd Gill,1965,D,1007,82,272,354,1214
868,Ted Hampson,1936,F,677,108,245,353,92
869,Rickard Rakell,1993,F,569,158,194,352,120
870,Tim Higgins,1958,F,706,154,198,352,719
871,Mathieu Perreault,1988,F,708,143,209,352,322
872,Perry Turnbull,1959,F,608,188,163,351,1247
873,Dave Lowry,1965,F,1084,164,187,351,1191
874,Bob Berry,1943,F,541,159,191,350,344
875,Niklas Sundstrom,1975,F,750,117,232,349,256
876,John Madden,1973,F,898,165,183,348,219
877,Lars Eller,1989,F,870,153,195,348,521
878,Jacques Richard,1952,F,556,160,187,347,307
879,Mike Corrigan,1946,F,594,152,195,347,698
880,Ted Donato,1969,F,796,150,197,347,396
881,Mikael Samuelsson,1976,F,699,149,197,346,370
882,Tuomo Ruutu,1983,F,735,148,198,346,596
883,Tyler Ennis,1989,F,700,144,202,346,224
884,Stan Weir,1952,F,642,139,207,346,183
885,Igor Korolev,1970,F,795,119,227,346,330
886,Justin Faulk,1992,D,760,113,233,346,375
887,Red Sullivan,1929,F,557,107,239,346,437
888,Vladimir Malakhov,1968,D,712,86,260,346,697
889,Marc-Edouard Vlasic,1987,D,1161,76,270,346,428
890,Sergio Momesso,1965,F,710,152,193,345,1557
891,Sergei Nemchinov,1964,F,761,152,193,345,251
892,Charlie Coyle,1992,F,703,131,214,345,263
893,Billy Harris,1935,F,770,126,219,345,193
894,Jared Spurgeon,1989,D,772,99,246,345,130
895,Marcel Pronovost,1930,D,1206,88,257,345,847
896,Mike Ramsey,1960,D,1070,79,266,345,1012
897,Gaye Stewart,1923,F,502,185,159,344,292
898,Kyle Connor,1996,F,384,178,166,344,88
899,Real Cloutier,1956,F,318,146,198,344,119
900,Reijo Ruotsalainen,1960,D,446,107,237,344,180
901,Tomas Jonsson,1960,D,552,85,259,344,482
902,Greg Polis,1950,F,615,174,169,343,391
903,Nick Mickoski,1927,F,705,158,185,343,315
904,Trent Klatt,1971,F,782,143,200,343,307
905,William Nylander,1996,F,439,137,206,343,106
906,Brian Skrudland,1963,F,881,124,219,343,1107
907,Mattias Ohlund,1976,D,909,93,250,343,885
908,Doug Lidster,1960,D,897,75,268,343,679
909,Pat Elynuik,1967,F,506,154,188,342,459
910,Duane Sutter,1960,F,731,139,203,342,1333
911,Bill Thoms,1910,F,549,135,207,342,172
912,Keith Brown,1960,D,876,68,274,342,916
913,Jake Guentzel,1994,F,375,161,180,341,164
914,Craig Laughlin,1957,F,549,136,205,341,364
915,Sami Salo,1974,D,878,99,240,339,286
916,Christian Ehrhoff,1982,D,789,74,265,339,517
917,Scott Arniel,1962,F,730,149,189,338,599
918,Robert Kron,1967,F,771,144,194,338,119
919,Martin Hanzal,1987,F,673,127,211,338,574
920,Joe Carveth,1918,F,502,150,187,337,81
921,Ryan McDonagh,1989,D,783,71,266,337,304
922,Seth Jones,1994,D,658,70,267,337,222
923,Pat Stapleton,1940,D,635,43,294,337,351
924,Cy Denneny,1891,F,329,247,89,336,296
925,Steve Heinze,1970,F,694,178,158,336,379
926,Paul Ysebaert,1966,F,532,149,187,336,217
927,Lynn Patrick,1912,F,455,145,191,336,240
928,Ian Laperriere,1974,F,1083,121,215,336,1956
929,Dale Tallon,1950,D,642,98,238,336,568
930,Cooney Weiland,1904,F,509,173,162,335,149
931,Kevin Miller,1965,F,620,150,185,335,429
932,Tomas Fleischmann,1984,F,657,137,198,335,200
933,Brad Stuart,1979,D,1056,80,255,335,565
934,Robert Svehla,1969,D,655,68,267,335,649
935,Randy Wood,1963,F,741,175,159,334,603
936,Curt Bennett,1948,F,580,152,182,334,347
937,Nick Bonino,1988,F,761,148,186,334,215
938,Blake Comeau,1986,F,909,141,193,334,573
939,Bobby Lalonde,1951,F,641,124,210,334,298
940,Chris Higgins,1983,F,711,165,168,333,220
941,Filip Kuba,1976,D,836,70,263,333,361
942,Johnny Wilson,1929,F,688,161,171,332,188
943,Simon Nolet,1941,F,562,150,182,332,187
944,Kevin Hayes,1992,F,553,137,195,332,182
945,Brooks Laich,1983,F,776,134,198,332,307
946,Dave Barr,1960,F,614,128,204,332,520
947,Orland Kurtenbach,1936,F,640,119,213,332,633
948,Ulf Samuelsson,1964,D,1080,57,275,332,2453
949,Steve Bozek,1960,F,641,164,167,331,309
950,Ted Irvine,1944,F,724,154,177,331,657
951,Paul Thompson,1906,F,582,153,178,331,346
952,Derian Hatcher,1972,D,1045,80,251,331,1581
953,Rod Seiling,1944,D,979,62,269,331,603
954,Gilles Tremblay,1938,F,509,168,162,330,164
955,Metro Prystai,1927,F,675,151,179,330,229
956,Miroslav Frycer,1959,F,415,147,183,330,486
957,Tom Fitzgerald,1968,F,1097,139,190,329,776
958,Mark Pavelich,1958,F,355,137,192,329,340
959,Todd Elik,1966,F,448,110,219,329,453
960,Erik Johnson,1988,D,857,88,241,329,502
961,Jim McKenny,1946,D,604,82,247,329,294
962,Rod Langway,1957,D,994,51,278,329,851
963,Ken Houston,1953,F,570,161,167,328,624
964,Doug Sulliman,1959,F,631,160,168,328,175
965,Jakob Silfverberg,1990,F,658,151,177,328,208
966,Ron Flockhart,1960,F,453,145,183,328,208
967,Michel Petit,1964,D,827,90,238,328,1839
968,Patrik Laine,1998,F,407,176,151,327,163
969,Alexandre Daigle,1975,F,616,129,198,327,186
970,Mikkel Bodker,1989,F,709,118,209,327,116
971,Tom Poti,1977,D,824,69,258,327,586
972,Patrik Berglund,1988,F,717,170,156,326,248
973,Johnny Peirson,1925,F,544,153,173,326,309
974,Bronco Horvath,1930,F,434,141,185,326,313
975,Ebbie Goodfellow,1907,F,557,135,191,326,511
976,Ron Wilson,1956,F,831,110,216,326,413
977,Doug Shedden,1961,F,416,139,186,325,176
978,Ken Schinkel,1932,F,636,127,198,325,163
979,Bob Dailey,1953,D,561,94,231,325,814
980,Tyler Myers,1990,D,840,87,238,325,634
981,Tony Leswick,1923,F,740,165,159,324,902
982,Willy Lindstrom,1951,F,582,161,162,323,200
983,Paul Holmgren,1955,F,527,144,179,323,1684
984,Parker MacDonald,1933,F,676,144,179,323,251
985,Alexei Ponikarovsky,1980,F,678,139,184,323,419
986,Dave Hunter,1958,F,746,133,190,323,918
987,Gord Murphy,1967,D,862,85,238,323,668
988,Bryan Berard,1977,D,619,76,247,323,500
989,Chris Stewart,1987,F,668,160,162,322,750
990,Pat Falloon,1972,F,575,143,179,322,141
991,Mike York,1978,F,579,127,195,322,135
992,Jeff Petry,1987,D,803,87,235,322,325
993,Leo Boivin,1931,D,1150,72,250,322,1196
994,Leo Labine,1931,F,643,128,193,321,728
995,Willie Huber,1958,D,655,104,217,321,950
996,Gilles Marotte,1945,D,808,56,265,321,921
997,Dennis Kearns,1945,D,677,31,290,321,386
998,Jim Roberts,1940,F,1006,126,194,320,623
999,Don Raleigh,1926,F,535,101,219,320,96
1000,Paul Martin,1981,D,870,50,270,320,238